			   NO  	textures/Brick32.xpm

SO textures/Brick32.xpm
C 38,    89  ,   255

	EA textures/Brick32.xpm
WE 			textures/Brick32.xpm



F 	99  ,	255,	0 


11111111111111111111111111111000000000000000000
10000000000000000000000000001111111111000000000
1N000000000000000000000000000000000001000000000
11110000000000000000000000000000000001000000000
00010000000000000000000000000000000001111111111
00010000000000000000000000000000000000000000001
00011111111111111111111111111111111111111111111




