			   NO  	textures/Brick32.xpm

SO textures/Brick32.xpm
C 38,    89  ,   255

	EA textures/Brick32.xpm
WE 			textures/Brick32.xpm



F 	99  ,	255,	0 


11111111111111111111111111111
10000000000000000000000000001111111111111111111111111111111111111111
100000000000000000000000000000000000000000000000000000000000E0000001
111100000000000000000000000000000000011111111111111111111111111111111
   10000000000000000000000000000000001111111111
   10000000000000000000000000000000000000000001
   11111111111111111111111111111111111111111111



