NO textures/Brick32.xpm
SO textures/Brick64.xpm
EA textures/Brick128.xpm
WE textures/wood3.xpm

C 103,102,99
F 115,100,64


11111111111111111111111111111
10000000000000000000000000001111111111
10000000000000000000000000000000000001
11110000000000000000000000000000000001
   100000000000000000000000000000000011111111111111111111111111111111
   10000000000000000000000000000000E0000000000000000000000000000001
   1111111111111111111111111111111111111111111111111111111111111111111




