			   NO  	textures/Brick32.xpm

SO textures/Brick32.xpm
C 38,    89  ,   255

	EA textures/Brick32.xpm
WE 			textures/Brick32.xpm



F 	99  ,	255,	0 


11111111111111111111111111111
10000000000000000000000000001111111111
1N000000000000000000000000000000000001
11110000000000000000000000000000000001
00010000000000000000000000000000000001111111111
00010000000000000000000000000000000000000000001
00011111111111111111111111111111111111111111111




