			   NO  	textures/Brick256.xpm

SO textures/Brick256.xpm
C 38,    89  ,   255

	EA textures/Brick256.xpm
WE 			textures/Brick256.xpm



F 	99  ,	255,	0 


11111111
10100001
10100001
10100001
10N01001
10010001
10000101
11111111


