NO textures/Brick32.xpm
SO textures/Brick64.xpm
EA textures/Brick128.xpm
WE textures/wood3.xpm

C 103,102,99
F 115,100,64

1 111 111 111 111 111 111 111
1 101 101 101 101 101 101 101
11101110111011101110111011101
10000000000000000000000000001111111111
10000000000000000000000000000000000001
11110000000000000000000000000000000001
   1000000000000S000000000000000000001111111111
   10000000000000000000000000000000000000000001
   10111011101110111011101110111011101110111011
   101 101 101 101 101 101 101 101 101 101 1011
   101 101 101 101 101 101 101 101 101 101 1011
   101 101 101 101 101 101 101 101 101 101 1011
   10111011101110111011101110111011101110111011
   10000000000000000000000000000000000000000001
   11111111111111111111111111111111111111111111




