NO textures/Brick32.xpm
SO textures/Brick64.xpm
EA textures/Brick128.xpm
WE textures/wood3.xpm

C 103,102,99
F 115,100,64

11111111111111111111
10000100030000100001
10S00300010000100001
10000100010000300001
11111111111111111111

