NO textures/Brick32.xpm
SO textures/Brick64.xpm
EA textures/Brick128.xpm
WE textures/wood3.xpm

C 103,102,99
F 115,100,64

11111111111111111111111
11110000000000000000001
   10000000000000000001
   10000000000000000001
   13333333333333333331
   1000010000101E000101
   11111111111111111111

