			   NO  	inorth

SO isouth
C 38,    89  ,   255

	EA ieast   
WE 			iwest  



F 	99  ,	255,	0 


1	111111111111111111111111111
11001111111111111111111111111
10000000000000000000000000001111111111
1N000000000000000000000000000000000001
11110000000000000000000000000000000001
   10000000000000000000000000000000001111111111
   10000000000000000000000000000000000000000001
   11111111111111111111111111111111111111111111




