NO textures/Brick32.xpm
SO textures/Brick64.xpm
EA textures/Brick128.xpm
WE textures/wood3.xpm

C 103,102,99
F 115,100,64

111111111111111111111
1W0000000000000000001
111111111111111111111
