			   NO  	textures/Brick128.xpm

SO textures/wood3.xpm
C 38,    89  ,   255

	EA textures/wood3.xpm
WE 			textures/Brick128.xpm



F 	99  ,	255,	0 


11111111111111111111111111111
10000000000000000000000000001111111111
1000W000000000000000000000000000000001
11110000000000000000000000000000000003
   10000000000000000000000000000000001111111111
   10000000000000000000000000000000000000000001
   11111111111111111111111111111111111111111111




