   WE                            textures/Brick64.xpm
NO      textures/wood4.xpm



SO textures/Brick64.xpm

F      17,    38,     64

EA textures/Brick64.xpm



C 218, 234, 235

1111111111111111111111111
10001100001000000000000E01   1111
1000110000000000111111001   1011
1000110000000000110001001   1111
1000000000100000000001001
1111111111111111111111111
