NO textures/wood1.xpm
SO textures/wood2.xpm
WE textures/brick1.xpm
EA textures/brick2.xpm
C 38,    89  ,   255



F 	99  ,	255,	0 


11111111111111111111111111111
10000000000000000000000000001111111111
1N000000000000000000000000000000000001
111100000000000S0000000000000000000001
   10000000000000000000000000000000001111111111
   10000000000000000000000000000000000000000001
   11111111111111111111111111111111111111111111




