NO textures/wood1.xpm
SO textures/wood2.xpm
WE textures/brick1.xpm
EA textures/brick2.xpm
C 38,    89  ,   255

F 	99  ,	255,	0 

1 111 111 111 111 111 111 111
1 101	101 101 101 101 101 101
11101110111011101110111011101
10000000000000000000000000001111111111
1N000000000000000000000000000000000001
11110000000000000000000000000000000001
   10000000000000000000000000000000001111111111
   10000000000000000000000000000000000000000001
   10111011101110111011101110111011101110111011
   101 101 101 101 101 101 101 101 101 101 1011
   101 101 101 101 101 101 101 101 101 101 1011
   101 101 101 101 101 101 101 101 101 101 1011
   10111011101110111011101110111011101110111011
   10000000000000000000000000000000000000000001
   11111111111111111111111111111111111111111111




