11111111111111111111111111111111111111111111111
1000000000C000000000011110000000000C00011100001
1000000000M000000000001111111111101111111100001
10000000000000000000001000000000101000000000001
10000000000000000P00000000000000000000000000001
10000000000000000000000000000000000000001110001
10000000000000000000000000000000000000001110001
100000000000000000000E0000000000000000001110001
10000000000000000000000000000000000000000000001
11111111111111111111111111111111111111111111111
